S000000000000000
1111111111111110
0000000000000000
0111111111111111
0000000000000000
1111111111111110
0000000000000000
0111111111111111
0000000000000000
1111111111111110
0000000000000000
0111111111111111
0000000000000000
1111111111111110
0000000000000000
000000000000000G