S000000000000000
1011111111111110
0000000000000000
0110111111111111
0000000000000000
1111011111111110
0000000000000000
0111101111111111
0000000000000000
1111110111111110
0000000000000000
0111111011111111
0000000000000000
1111111101111110
0000000000000000
000000000000000G