S0##############################################################
000000000000000000000000000000000000000000000000000000000000000#
#00000000000000000000000000000000000000000000000000000000000000#
##00############################################################
#00000000000000000000000000000000000000000000000000000000000000#
#00000000000000000000000000000000000000000000000000000000000000#
#00000000000000000000000000000000000000000000000000000000000000#
#############################################################00#
#00000000000000000000000000000000000000000000000000000000000000#
#00000000000000000000000000000000000000000000000000000000000000#
#00000000000000000000000000000000000000000000000000000000000000#
##00############################################################
#00000000000000000000000000000000000000000000000000000000000000#
#00000000000000000000000000000000000000000000000000000000000000#
#00000000000000000000000000000000000000000000000000000000000000#
#############################################################00#
#00000000000000000000000000000000000000000000000000000000000000#
#00000000000000000000000000000000000000000000000000000000000000#
#00000000000000000000000000000000000000000000000000000000000000#
##00############################################################
#00000000000000000000000000000000000000000000000000000000000000#
#00000000000000000000000000000000000000000000000000000000000000#
#00000000000000000000000000000000000000000000000000000000000000#
#############################################################00#
#00000000000000000000000000000000000000000000000000000000000000#
#00000000000000000000000000000000000000000000000000000000000000#
#00000000000000000000000000000000000000000000000000000000000000#
##00############################################################
#00000000000000000000000000000000000000000000000000000000000000#
#00000000000000000000000000000000000000000000000000000000000000#
#00000000000000000000000000000000000000000000000000000000000000#
#############################################################00#
#00000000000000000000000000000000000000000000000000000000000000#
#00000000000000000000000000000000000000000000000000000000000000#
#00000000000000000000000000000000000000000000000000000000000000#
##00############################################################
#00000000000000000000000000000000000000000000000000000000000000#
#00000000000000000000000000000000000000000000000000000000000000#
#00000000000000000000000000000000000000000000000000000000000000#
#############################################################00#
#00000000000000000000000000000000000000000000000000000000000000#
#00000000000000000000000000000000000000000000000000000000000000#
#00000000000000000000000000000000000000000000000000000000000000#
##00############################################################
#00000000000000000000000000000000000000000000000000000000000000#
#00000000000000000000000000000000000000000000000000000000000000#
#00000000000000000000000000000000000000000000000000000000000000#
#############################################################00#
#00000000000000000000000000000000000000000000000000000000000000#
#00000000000000000000000000000000000000000000000000000000000000#
#00000000000000000000000000000000000000000000000000000000000000#
##00############################################################
#00000000000000000000000000000000000000000000000000000000000000#
#00000000000000000000000000000000000000000000000000000000000000#
#00000000000000000000000000000000000000000000000000000000000000#
#############################################################00#
#00000000000000000000000000000000000000000000000000000000000000#
#00000000000000000000000000000000000000000000000000000000000000#
#00000000000000000000000000000000000000000000000000000000000000#
##00############################################################
#00000000000000000000000000000000000000000000000000000000000000#
#00000000000000000000000000000000000000000000000000000000000000#
#000000000000000000000000000000000000000000000000000000000000000
##############################################################0G